# 3 1	# 3 1	# 3 1	# 3 1	# 3 1	# 3 1	# 3 1	# 3 1	# 3 1	# 3 1	# 3 1	# 3 1	# 3 1	# 3 1	# 3 1	# 3 1	# 3 1
# 3 1	A 3 1	. 3 1	. 3 1	. 3 1	. 3 1	. 3 1	. 3 1	. 3 1	. 3 1	. 3 1	# 3 1	# 3 1	E 3 1	B 3 1	# 3 1	# 3 1
# 3 1	. 3 1	. 3 1	G 3 1	G 3 1	G 3 1	G 3 1	# 3 1	# 3 1	. 3 1	. 3 1	. 3 1	# 3 1	. 3 1	. 3 1	# 3 1	# 3 1
# 3 1	. 3 1	. 3 1	. 3 1	. 3 1	. 3 1	# 3 1	Y 3 1	# 3 1	# 3 1	# 3 1	. 3 1	. 3 1	. 3 1	. 3 1	P 3 1	# 3 1
# 3 1	S 3 1	. 3 1	. 3 1	. 3 1	. 3 1	. 3 1	. 3 1	. 3 1	D 3 1	. 3 1	. 3 1	. 3 1	. 3 1	# 3 1	# 3 1	# 3 1
# 3 1	P 3 1	. 3 1	. 3 1	. 3 1	. 3 1	. 3 1	. 3 1	T 3 1	# 3 1	Y 3 1	# 3 1	. 3 1	# 3 1	# 3 1	# 3 1	# 3 1
# 3 1	B 3 1	K 3 1	. 3 1	. 3 1	. 3 1	. 3 1	# 3 1	# 3 1	# 3 1	# 3 1	. 3 1	. 3 1	# 3 1	# 3 1	# 3 1	# 3 1
# 3 1	B 3 1	B 3 1	. 3 1	T 3 1	. 3 1	. 3 1	# 3 1	G 3 1	# 3 1	. 3 1	. 3 1	# 3 1	# 3 1	# 3 1	# 3 1	# 3 1
# 3 1	# 3 1	# 3 1	# 3 1	# 3 1	# 3 1	. 3 1	. 3 1	. 3 1	. 3 1	. 3 1	. 3 1	# 3 1	# 3 1	# 3 1	# 3 1	# 3 1
# 3 1	# 3 1	# 3 1	. 3 1	P 3 1	# 3 1	. 3 1	# 3 1	# 3 1	# 3 1	# 3 1	# 3 1	# 3 1	# 3 1	# 3 1	# 3 1	# 3 1
# 3 1	# 3 1	# 3 1	. 3 1	# 3 1	# 3 1	. 3 1	# 3 1	# 3 1	# 3 1	# 3 1	# 3 1	# 3 1	# 3 1	# 3 1	# 3 1	# 3 1
# 3 1	# 3 1	# 3 1	. 3 1	. 3 1	. 3 1	. 3 1	. 3 1	. 3 1	# 3 1	# 3 1	# 3 1	# 3 1	# 3 1	# 3 1	# 3 1	# 3 1
# 3 1	. 3 1	. 3 1	. 3 1	# 3 1	# 3 1	. 3 1	. 3 1	. 3 1	. 3 1	B 3 1	B 3 1	B 3 1	B 3 1	# 3 1	# 3 1	# 3 1
# 3 1	K 3 1	# 3 1	# 3 1	# 3 1	# 3 1	# 3 1	. 3 1	. 3 1	. 3 1	B 3 1	B 3 1	K 3 1	T 3 1	# 3 1	# 3 1	# 3 1
# 3 1	# 3 1	# 3 1	# 3 1	# 3 1	# 3 1	# 3 1	# 3 1	# 3 1	# 3 1	# 3 1	# 3 1	# 3 1	# 3 1	# 3 1	# 3 1	# 3 1